1111111111111111111111111111111111111
100001EC10000000000000000000000000001
1000P00000000000000000000000000000001
1000000000000000000000000000000000001
1000000010000000000000000000000000001
1000000010000000000000000000000000001
1000000010000000000000000000000000001
1000000010000000000000000000000000001
1000000010000000000000000000000000001
1000000010000000000000000000000000001
1000000010000000000000000000000000001
1000000010000000000000000000000000001
1000000010000000000000000000000000001
1000000010000000000000000000000000001
1000000010000000000000000000000000001
1000000010000000000000000000000000001
1000000010000000000000000000000000001
1000000010000000000000000000000000001
1000000010000000000000000000000000001
1000000010000000000000000000000000001
1000000010000000000000000000000000001
1000000010000000000000000000000000001
1000000010000000000000000000000000001
1000000010000000000000000000000000001
1000000010000000000000000000000000001
1000000010000000000000000000000000001
1000000010000000000000000000000000001
1000000010000000000000000000000000001
1000000010000000000000000000000000001
1111111111111111111111111111111111111