111111111111

11111ECP1111
110000000011
111111111111