11111111111111
10111C0101E111
10000000P01111
11111111111111